XXXXXXXXXXXXXXXXXXXXXXXXXXXXXXXXXXXXXXXX
X       X                X        X X  X
X     X   X X  X            X          X
X      X    X                X       X X
X   X XXX X                    X  X   XX
X     X X      X       XX              X
X         X             X        X     X
X                                      X
X                       X     X        X
X                        XX            X
X        X             XX              X
X  XX    X     X X     X               X
X                XX  X         X  X   XX
X                                X X   X
X              X       X          XX   X
X X   X     X   X         X X       X  X
X X           X     X      X           X
X     X                             XX X
X     X     X   X  X          X        X
X                X                X    X
X X X  X        X      X  X           XX
XX                     X         XX  XXX
X   X   X X             X   X          X
X                    X X               X
X X               X                    X
X X      X                           X X
X       X   X    X                     X
X                X                X    X
X      X           X  X      X        XX
X                XX                 X  X
X                X                   X X
X            X                X      X X
X                        X     X       X
X                  X   X   X           X
X                 X   X   X  X     X   X
X       X                              X
X       X                  X    X      X
X        X            XX   X      X    X
X                       X            XXX
XXXXXXXXXXXXXXXXXXXXXXXXXXXXXXXXXXXXXXXX
